KKKKKKKKKKKKKKKKKKKK
K                  K
K                  K
K            J     K
KKKKKKKKK    J     K
K       K    J     K
K       K    J     K
K   *   K          K
K       K          K
KKKKKKKKKKKKKKKKKKKK
